1111111111111111111111111111111111111
10000P0010000000000000011111000000001
1000111110001100011111000000000000101
1010000000110001000111111000000001111
10001111111101010100000000000C0000111
1110111000C00101010100001111100000101
1000000011110100000001000000E0001C111
1111111111111111111111111111111111111