111111111111111111111111111111111
10000P001000000000000001111100001
100011111000110001111100000000101
101000000011000100011111100011111
100011111111010101000000000000111
111011100000010101011111100000101
100000001111010001000000E00011111
111111111111111111111111111111111