111111111111111111111111111111111
10000P001000000000000001111100001
100011111000110001111100000000101
101000000011000100011111100011111
1000111111110101010000000C0000111
1110111000C0010101011111100000101
100000001111010001000000E00011111
111111111111111111111111111111111