1111111111111111111111111111111111111111111111111111111
1E0000000000000C00000C000000000001111111111111111111111
1010010010101010001001000000010100000000000000000000001
1010010010101010001001000000010100000000000000000000001
1010010010101010001001000000010100000000000000000000001
1010010010101010001001000000010100000000000000000000001
1010010010101010001001000000010100000000000000000000001
1010010010101010001001000000010100000000000000000000001
1010010010101010001001000000010100000000000000000000001
1010010010101010001001000000010100000000000000000000001
1010010010101010001001000000010100000000000000000000001
1010010010101010001001000000010100000000000000000000001
1010010010101010001001000000010100000000000000000000001
1010010010101010001001000000010100000000000000000000001
1010010010101010001001000000010100000000000000000000001
1010010010101010001001000000010100000000000000000000001
1010010010101010001001000000010100000000000000000000001
1010010010101010001001000000010100000000000000000000001
1010010010101010001001000000010100000000000000000000001
1010010010101010001001000000010100000000000000000000001
1010010010101010001001000000010100000000000000000000001
1010010010101010001001000000010100000000000000000000001
1010010010101010001001000000010100000000000000000000001
1010010010101010001001000000010100000000000000000000001
1010010010101010001001000000010100000000000000000000001
1010010010101010001001000000010100000000000000000000001
1P0000000C00C000000000T000000000000000000000000000000C1
1111111111111111111111111111111111111111111111111111111